**********
*P       *
*   ******
*     *  *
*   M *  *
*  *     *
****     *
*  *     *
*       G*
**********
